##########################
#                        #
#                        #
#           ^            #
#                        #
##########################%