##########################
#                       v#
#                        #
#-----      ^       -----#
#                        #
#-----              -----#
#                        #
#-----              -----#
#                        #
##########################%