##########################
#                       >#
#                        #
#-----      <       -----#
#                        #
#-----              -----#
#                        #
#-----              -----#
#                        #
##########################%