   #####################################################################################################################
  #                                                                                                        |           #
 #*                                                                                                        |            #
#                                                                                                          |            #
#                                                                                                          |           #
#                                                                                                          |----------+#
#                          *                                                                                           #
#                                                                                                                      #
#                                                                                                                      #
#            |--------|                                                                                                 #
#            |      , |                                               *                                                  #
#            |        |                                                                                                   #
#            |---+----|                                                                                                   #
#                                                                                                                        #
#                                                                                                                       #
#                                                                                                                      #
#                                                                                                                      #
#                                                                                                                      #
#                                                         |-----------|                                                #
#                                                         |           |                                                #
#                                                         |           |                                                #
#                                                         |           |                                                #
#                                                         |-----x-----|                                                #
#                                                                                                                      #
#                                                                                                                      #
#                                                                                                                      #
#                                          *                                                                           #
#                                                                                                                      #
#                                                                                                                      #
############################################                        ####################################################
                                            ########################                                                    
                                                                                                                        
                                                                                                                        
                                                                                                                        
                                                                                                                        
                                                                                                                        
                                                                                                                        
                                                                                                                        %