########################################################################################################################
#                                                                                                                      #
# *                                                                                                                    #
#                                                                                                                      #
#                                                                                                                      #
#                                                                                                                      #
#                                                                                                                      #
#                                                                                                                      #
#                                                                                                                      #
#            |--------|                                                                                                #
#            |      , |                                               *                                                #
#            |        |                                                                                                #
#            |---+----|                                                                                                #
#                                                                                                                      #
#                                                                                                                      #
#                                                                                                                      #
#                                                                                                                      #
#                                                                                                                      #
#                                                         |-----------|                                                #
#                                                         |           |                                                #
#                                                         |           |                                                #
#                                                         |           |                                                #
#                                                         |-----x-----|                                                #
#                                                                                                                      #
#                                                                                                                      #
#                                                                                                                      #
#                                          *                                                                           #
#                                                                                                                      #
#                                                                                                                      #
########################################################################################################################%