                          #############################
               ###########   |------------------|      ################
          #####              |                  |                      ###############
        ##                   |                  |                                     ########
      ##   |--|              |--/------------/--|                                |            ####
    ##     |> /    *                                                             |                ##
   #       |--|                                                                                     ##
   #                                                                             |       |-------|    #
  #   |--------|  |--------|                                *                            |       |     #
 #*   |      , |  |        |                                                     |       |---+---|     #
#     |        |  |        |                                                     |                     #
#     |---/----|  |------/-|                                                     |                     #
#                                                                                                     #
#  |--/-----|                        *                                                               #
#  |        |                                                                                       #
#  |        |                                                                                  ----#
#  |--------|                                                                                     #
#                                                           *                                    #
#                                                                                                #
#                   *                                                                           #
#                                                                           *                  #
#                                                                                             #
#-------------------------|                                                                  #
#            *  *  *  *  *|                                                                ##
#     |--|         *  *  *|                                                               #
#  |--|  |------|         |                                                             ##
#  |*           /                                                                      #
#  |--|  |------|                                                                     #
#    >|--|         *  *  *|                                                       ####
#            *  *  *  *  *|                                                    ###
###########################                                                   #
                           ##                                              ###
                             ##                          *                #
                               ###                                      ##
                                  ####                                 #
                                      #####                          ##
                                           ##########################%