   #####################################################################################################
  #   |--------|  |--------|                                                     |                     #
 #*   |      , |  |        |                                                     |                     #
#     |        |  |        |                                                     |                     #
#     |---/----|  |------/-|                                                     |                     #
#                                                                                |                    #
#  |--/-----|                        *                                           |                   #
#  |        |                                                                    |                  #
#  |        |                                                                                  ----#
#  |--------|                                                                                     #
#                                                           *                                    #
#                                                                                               #
#                   *                                     |-------|                            #
#                                                         |       |                           #
#                                                         |---+---|                          #
#                                                                                           #
#                                                                                           #
#                                                                                           #
#                                                                                   *       #
#                                                                                           #
#                                                                                           #
#                                                                                           #
#                                                                                           #
############################################                        #########################
                                           #   *      *      *      #
                                           #                        #
                                           #                        #
                                           #   *    |-/--|   *      #
                                           #        |   v|          #
                                           ##########################%