     #####################################################################
     #                                                                   #   
     # >                                   *                             #   
     #                                                                   #  
     ############################################################        #   
                                                                #        #   
                                                                #        #   
                                                                #        #   
                                                                #        #   
 ################################################################        #   
 #                                                                       #  
 #        *                                                              #  
 #                                                                       #   
 #   ###########      ################     ###############################   
 #   #         #      #              #     #                                 
 #   #         #      #              #     #                                 
 #   #         #      #              #     #                                 
 #   #         #      #              #     #                                 
 #   #         #      #              #     #                                 
 #   #         #      #              #     #                                 
 #   #         #      #              #     #                                 
 #   #         #      #              #     #                                 
 #   ###########      ################     ###############################   
 #                                                                       #   
 #                                                                       #   
 ################     #############################################      #   
                #     #                                           #      #   
                #     ###################                         #      #   
                #                  *    #  ##########             #      #   
                #                       #  #        #             #      #   
                #          *            #  #        #             #      #   
     ########   #                 *     #  #        #             #      #   
     #      #   #                       #  #        #             #      #   
     #      #   #########################  #        #             #      #   
     ### ####                              ##### ####             #      #   
       # #                                     # #                #      #   
    ####+#######################################/##################      #   
    #<                                                                   #   
    ######################################################################%