     #####################################################################
     #                                                                   #   
     # ^                                   *                             #   
     #                                                                   #  
     ############################################################        #   
                                                                #        #   
                                                                #        #   
                                                                #        #   
                                                                #        #   
 ################################################################        #   
 #                                                                       #  
 #        *                                                              #  
 #                                                                       #   
 #   ###########      ################     ###############################   
 #   #         #      #              #     #                                 
 #   #         #      #              #     #                                 
 #   #         #      #              #     #                                 
 #   #         #      #              #     #                                 
 #   #         #      #              #     #                                 
 #   #         #      #              #     #                                 
 #   #         #      #              #     #                                 
 #   #         #      #              #     #                                 
 #   ###########      ################     ###############################   
 #                                                                       #   
 #                                                                       #   
 ################     #############################################      #   
                #     #                                           #      #   
                #     ###################                         #      #   
                #                  *    #  ##########             #      #   
                #                       #  #        #             #      #   
                #          *            #  #        #             #      #   
     ########   #                 *     #  #        #             #      #   
     #      #   #                       #  #        #             #      #   
     #      #   #########################  #        #             #      #   
     ### ####                              ##### ####             #      #   
       # #                                     # #                #      #   
    ####+#######################################/##################      #   
    #^                                                                   #   
    ######################################################################%